

C  102,240,255

NO /Users/mohtakra/Desktop/Cub3d_rayCasting/textures/eagle.xpm
SO /Users/mohtakra/Desktop/Cub3d_rayCasting/textures/bluestone.xpm
EA /Users/mohtakra/Desktop/Cub3d_rayCasting/textures/colorstone.xpm
WE /Users/mohtakra/Desktop/Cub3d_rayCasting/textures/redbrick.xpm

F  200,5,5




111111111111111111111111111111111111111111111111111111111111111111111111111111111111111111111111
100000000000000000000000000000000000000000000000000000000000000000000000000000000000000000000001
100000000000000000000000000000000000000000000000000000000000000000000000000000000000000000000001
100000000000000000000000011011111111111111111111111111111111111111111111111111111111111111111101
100010000000000E00010000001000000000000000000000000000000000000000000000000000000000000000000001
100000000000000000000000111111111111111111111111111111111111111111111111111111111111111111111111
100000000000000000000000111111111111111111111111111111111111111111111111111111111111111111111111
111111111111111111111111111111111111111111111111111111111111111111111111111111111111111111111111





