


NO ./path_to_the_north_texture
SO ./path_to_the_south_texture
EA ./images/hello
WE ./path_to_the_west_texture
F 220,200,3
C 225,30,0





  1     1111111111111111111111111
        10000000001100000000000P1
        1011000001110000000000001
        1001000000000000000000001
111111111011000001110000000000001111 11
100000000011000001110111111111111
11110111111111011100000010001
11110111111111011101010010001
 1000000110101011101000010001
1000000100000011011100010001
10000000N000001101110010001 
110000011111010111111110000111
11110111   10101 101 11010001
1111111111111111 111 11111111   





