


NO /Users/mohtakra/Desktop/Cub3d_rayCasting/textures/eagle.xpm
SO /Users/mohtakra/Desktop/Cub3d_rayCasting/textures/bluestone.xpm
EA /Users/mohtakra/Desktop/Cub3d_rayCasting/textures/colorstone.xpm
WE /Users/mohtakra/Desktop/Cub3d_rayCasting/textures/redbrick.xpm
F  2,5,5
C  102,240,255





11111111111111111111111111
10000000000000000000000011
10000000000000000000000011
100010000000000E0001000011
10000000000000000000000011
10000000000000000000000011
11111111111111111111111111





