NO ./path_to_the_north_texture
SO ./path_to_the_south_texture
EA ./images/hello
WE ./path_to_the_west_texture

F 220,200,3
C 225,30,0




                                1
  1     11111111111111111111111101111
        100000000011000000000000100001
        1011000001110000000000001000001
        100100000000000000000000100001
1111111110110000011100000000000010001
100000000011000001110111111111110011
11110111111111011100000010001   11
11110111111111011101010010001
11000000110101011100000010001
10000001000000001100000010001
10000000000000001101010010001
11000001110101011111111000W0111
11110111 1110101 101 11010001
11111111 1111111 111 11111111
